+++++++++++++++++++++
+ eE    hH +Dd     a+
+a++++++++ ++++++++A+
+A+     Y+ +X       +
+ + ++++++ ++++++ +E+
+ +               +e+
+ + +           + + +
+ + +   +++++   + +h+
+d+y+       +   +x+H+
+D+++   + 0 +   +++++
+       +   +       +
+++++++++++++++++++++
