++++++++++++++++
+0   ABCDE     +
+            + +
+          +e+ +
+          +++ +
+    +     +E  +
+ ++ + + + +   +
+  + + + + +   +
+  + + + + +   +
+  + + + + +   +
+  + + + + +   +
+  + + + + +   +
+  + + + + +   +
+  +a+ + + +   +
+  +++ + + +   +
+   A+ + + +   +
+    + + + +   +
+    + + + +   +
+    + + +d+   +
+    + + +++   +
+    + + +D    +
+    + + +     +
+    + + +     +
+    +b+ +     +
+    +++ +     +
+     B+c+     +
+      +++     +
+       C      +
++++++++++++++++
