+++++++
+++f+++
+++F+++
+kKfWw+
+++ +++
++o  ++
++F +++
+++ +++++++
+ 0       +
+J+ +b+H+h+
+I+F+d+H+h+
+H+f+f+J+j+
+G+++h+H+h+
+F+++j+H+h+
+E+++i+H+h+
+D+++g+H+h+
+C+++e+H+h+
+B+++c+H+h+
+A+++a+++O+
+++++++++O+
+++++++++++
