blue: 0,A
red: 1,B
+++++++++
+    0+a+
+ +++++A+
+ +++++ +
+       +
+ +++++ +
+B+++++ +
+b+1    +
+++++++++
