+++++++++
+ 1     +
+0  A a +
+ B  b  +
+++++++++
