blue: 0,A,C
red: 1,B
green: 2,3,4,5,6,7,8,9,D,E,F,G,H,I,J,K
+++++             +++++++++++++++++++++
+0A +             +  + b              +
+   +++++++++++++++  +*************** +
+                    +                +
+              ****+++++****          +
+   1B*              a                +
+    34567892  ****+++++****     *    +
+    DEFGHIJK        +          *C*   +
+ c  defghijk        +                +
+++++++++++++++++++++++++++++++++++++++
