red: 0, 1, 2, 3, A
blue: 4, B
+++++++++++++++++++
+        A2       +
+                 +
+   +++++a+++++   +
+1  +         +   +
+A  a    B    a  A+
+   +         +  3+
+   +++++a+++++   +
+                 +
+b4     0A        +
+++++++++++++++++++
