magenta: 2,B,D
red: 0,C
green: 4,1,F,E,G
yellow: 3,H
+++++++++++++
+d ++efg 1  +
+  F++++C   +
+          0+
+  B++++2  G+
+c  +H +bD E+
++++++ ++++++
+e E      h3+
+e+ +E   4  +
+++++++++++++
