red:0,1,M
green:2,3,B
blue:4,5,J
orange:6,7,P
++++++++++++++++
+M+m++b++j++p+B+
+++0++2++4++6+++
+p            m+
+++ ++M++M++ +++
+++ ++B++B++ +++
+j  MB PJ BM  b+
+++ ++P++J++ +++
+++ ++J++P++ +++
+b  MB JP BM  j+
+++ ++B++B++ +++
+++ ++M++M++ +++
+m            p+
+++1++3++5++7+++
+J+p++j++b++m+P+
++++++++++++++++
