++++++++++++++++++++++++++++++++++++++++++++++++++++++++
+ this is a fosa level made by jada 0+       +         +
+++++++++++++++++++++++++++++++++++  +       +         +
+ ADOBE IS A SMELLY SAD JAVA THIEF                     +
+ +++++++++++++++++++++++++++++++++  +++++++++         +
+ +                                  +c g k n+         +
+ ++++++++++++++++++++++++++++++++++++       +         +
+ zzzzzzzzzzzzzzzzzzzzzzzzzzzzzzzzzzz        +++++++ +++
+ ++++++++++++++++++++++++++++++++++++       +         +
+ ZZZZZZZZZZZZZZZZZZZZZZZZZZZZZZZZZZZ+x u r q+         +
+ ++++++++++++++++++++++++++++++++++++++++++++         +
+        +         +                +                  +
+CGKNQRUX+                 +                 +         +
+++++++++++ ++++++++++++++++++++++++++++++++++++++++++++
+                                                      +
+                                                      +
+                                                      +
+                                                      +
+                                                      +
+ZZZZZZZZZZZZZZZZZZZZZZZZZZZZZZZZZZZZZZZZZZZZZZZZZZZZZZ+
+RUCK RUCK RUCK RUCK RUCK RUCK RUCK RUCK RUCK RUCK RUCK+
++++++++++++++++++++++++++++++++++++++++++++++++++++++++