++++++++++++++++++++
+t+NXXXTXXRXXXXXO+h+
+h+XXXXXHXXXEXXXK+a+
+e+TXXXXXXXXXXXXX+s+
+ +XXXIXXXXXXHXXX+ +
+p+XXXHXXXXXXXXXX+t+
+i+XXXXXXXAXXXXXX+h+
+n+XXXXXSXXXXXXXX+e+
+k+              + +
+             0   x+
+p+              + +
+a+XXXPXXXXXXFXXX+f+
+n+XXXTXXXTXXXXXP+a+
+t+XXAXXXXXXAXXXX+c+
+h+XXXNXEXXXXXCXX+t+
+e+XXXXXXXXXXXXXX+o+
+r+NXXHXXXEXXXXXR+r+
++++++++++++++++++++
