+++++++++++++++++++
+v+i+v e+ +l e+s+ +
+c+h+e+n+a+p+a+n+s+
+E P+S+V+A+L+N+S N+
+C+N+E+C+V+H+E+A+I+
+++   +     +   +++
+++ +++++ +++++ +++
+++ SAfo+ +saFO +++
+++++++++ +++++++++
+                 +
+        0        +
+                 +
+++++++++++++++++++
