+++         +++
+a+         +A+
+d+         +B++
+c+         +C +
+b+   +++   +D++
+ +   + +   + +
+ +++++ +++++ +
+      0      +
+++++++++++++++