orange: 0,A
blue: 1,B
green: 2,C
red: 3,D
++++++++++++++++++
+ *AB    * cd01  +
+ ++++++ +++++++ +
+ *    + +23   * +
+ *    + +     * +
+ *    + +     * +
+ *    + +     * +
+                +
++++++++ **** ***+
       + **** ***+
       + DC    ab+
       +++++++++++
