orange: 0,A,C
blue: 1,B,D
+++++++++++++++++
+       0   *A a+
+ **1Dd     *  *+
+ ++++++++++*B b+
+ **    ***    *+
+    **     **Cc+
+++++++++++++++++
